# 格式为日文[Tab]中文[Tab]解释(可不写)，参考项目wiki

# 主要角色 -------------------------------------------------------------------

悠志郎	悠志郎	人名，男性，全名"贵条悠志郎"（貴条 悠志郎，たかじょう ゆうしろう），年轻人，归国留学生，本作主人公，家族被人陷害而破产，父母自杀，妹妹(奈奈子)病亡，为复仇回到日本，冷酷、复仇心极强、精于算计、善于伪装、情感压抑
ゆうしろうちゃん	小悠志郎	人名，男性，悠志郎的称呼
悠志郎ちゃん	小悠志郎	人名，男性，悠志郎的称呼
貴条悠志郎	贵条悠志郎	人名全名，男性，即"悠志郎"
坊ちゃま	少爷	人名代称，男性，桐山对悠志郎的称呼
にいさま	哥哥大人	人名代称，男性，奈奈子对悠志郎的称呼
兄さま	哥哥大人	人名代称，男性，奈奈子对悠志郎的称呼
おにーさん	哥哥	人名代称，男性，苹果对悠志郎的称呼

奈々子	奈奈子	人名，女性，全名"贵条奈奈子"（貴条 奈々子，たかじょう ななこ），少女，学生，已故，病弱、温柔、依赖哥哥，悠志郎的妹妹，因病需要定期服药，家族破产后无法负担药费而病逝
貴条奈々子	贵条奈奈子	人名全名，女性，即"奈奈子"

貴条	贵条	人名姓氏，悠志郎和奈奈子的姓氏，通常指悠志郎(男性)

セシリア	塞西莉亚	人名，女性，全名"塞西莉亚·斯图尔特"（セシリア・スチュワート），年轻人，美国财阀斯图尔特家的千金(实际是养女)，随父亲来日进行商业谈判，高傲、自信、异国风情、跳脱、有主见、后期被悠志郎控制后精神崩溃
セシリアさん	塞西莉亚小姐	人名，女性，塞西莉亚的称呼
セシリア・スチュワート	塞西莉亚·斯图尔特	人名全名，女性，即"塞西莉亚"
スチュワート	斯图尔特	家族名/人名姓氏，塞西莉亚的姓氏，通常也代指塞西莉亚的父亲(美国财阀，商人气质、精明、对女儿有扭曲的爱欲、伪善)

紫子さん	紫子小姐	人名，女性，紫子的称呼
紫子	紫子	人名，女性，全名"稚谷紫子"（稚谷 紫子，ちや ゆかりこ），少女，学生，名门稚谷家的独生女，父亲涉嫌陷害悠志郎家族，纯真、善良、浪漫、感性、易轻信他人、有韧性但精神脆弱
稚谷紫子	稚谷紫子	人名全名，女性，即"紫子"
稚谷	稚谷	家族名/人名姓氏，紫子的姓氏，通常也代指紫子的父亲(陷害了主人公悠志郎的家族)
稚谷家	稚谷家	紫子的家族，陷害悠志郎家的共谋

蘭子	兰子	人名，女性，全名"久岛兰子"（久島 蘭子，くしま らんこ），年轻人，久岛家独生女，大小姐，知性美貌，面无表情、心不在焉、超脱尘世、略显寂寥、失恋后封闭情感
蘭子さま	兰子大人	人名，女性，兰子的称呼
蘭子さん	兰子小姐	人名，女性，兰子的称呼
蘭子お嬢さま	兰子大小姐	人名，女性，兰子的称呼
久島蘭子	久岛兰子	人名全名，女性，即"兰子"
久島	久岛	人名姓氏，兰子的姓氏，通常也代指兰子的父亲(老年，傲慢、豪爽、自信、有变态性癖)
久島氏	久岛先生	人名代称，男性，代指兰子的父亲(老年，傲慢、豪爽、自信、有变态性癖)

智花	智花	人名，女性，全名"水越智花"（水越 智花，みずこし ともか），年轻人，美术学校裸体模特，同时在夜总会打工，与紫子表面朋友实则嫉妒紫子，泼辣、现实、嫉妒心强、有行动力、善于伪装，悠志郎的复仇协助者
智花さん	智花小姐	人名，女性，智花的称呼
水越智花	水越智花	人名全名，女性，即"智花"
水越	水越	人名姓氏，智花的姓氏

詩帆里	诗帆里	人名，女性，全名"明神诗帆里"（明神 詩帆里，みょうじん しほり），少女，高峰神社的巫女，利仓的侄女，天真无邪、无防备、纯真
詩帆里ちゃん	小诗帆里	人名，女性，诗帆里的称呼
詩帆里くん	诗帆里小姐	人名，女性，诗帆里的称呼
明神詩帆里	明神诗帆里	人名全名，女性，即"诗帆里"
明神	明神	人名姓氏，诗帆里的姓氏

環	环	人名，女性，全名"小野寺环"（小野寺 環，おのでら たまき），年轻人，小野寺家独生女，四季风出版社的编辑，自尊心极高，高傲，新时代女性主张者
環さん	环小姐	人名，女性，环的称呼
環女史	环女士	人名，女性，环的称呼
小野寺環	小野寺环	人名全名，女性，即"环"
小野寺	小野寺	人名姓氏，环的姓氏，通常也代指环的父亲(老年，小野寺家当主，四季风出版社大股东，与女儿环关系恶劣)

りんご	苹果	人名，女性，外表似少女，真实年龄200岁，自称座敷童子(座敷わらし)，只有悠志郎能看见她，天真无邪、无防备
座敷わらし	座敷童子	人名代称，女性，苹果对自己的称呼

みのり	实里	人名，女性，全名"酒井实里"（酒井 みのり，さかい みのり），少女，久岛家女仆，兰子的贴身侍女，献身、有受虐倾向、顺从、习惯服从命令
みのりちゃん	小实里	人名，女性，实里的称呼
みのりくん	实里小姐	人名，女性，实里的称呼
酒井みのり	酒井实里	人名全名，女性，即"实里"
酒井	酒井	人名姓氏，实里的姓氏

サツキ	皋月	人名，女性，全名"清水皋月"（清水 サツキ，しみず さつき），年轻人，见习修女，悠志郎的青梅竹马，善良、纯真、信仰虔诚、母性本能强
シスタア	修女	职业名/人名称呼，女性，通常指皋月
シスタアサツキ	修女皋月	人名，女性，皋月的称呼
清水サツキ	清水皋月	人名全名，女性，即"皋月"
清水	清水	人名姓氏，皋月的姓氏

千紘	千纮	人名，女性，全名"若月千纮"（若月 千紘，わかつき ちひろ），少女，若月家（陷害悠志郎家的仇家）之女，天才钢琴少女，完美主义、神经质、自尊心强、嫉妒心强、情绪不稳定
千紘ちゃん	小千纮	人名，女性，千纮的称呼
千紘さん	千纮小姐	人名，女性，千纮的称呼
若月千紘	若月千纮	人名全名，女性，即"千纮"
若月	若月	人名姓氏，千纮的姓氏，通常也代指千纮的父亲(新兴财阀，冷酷、功利、伪善，陷害悠志郎家的仇家之一)
若月家	若月家	陷害悠志郎家的仇家，千纮的本家

# 路人角色 -------------------------------------------------------------------

桐山	桐山	人名，男性，老年，悠志郎家的老仆，家族破产后仍追随悠志郎，负责情报收集和联络，忠诚、冷静、能干、寡言、对主家忠心耿耿

ロバート	罗伯特	人名，男性，年轻人，塞西莉亚的婚约者，实业家之子，认真、清廉、爱塞西莉亚、易嫉妒、精神脆弱

山田	山田	人名，男性，中年，利仓的靠山，暴发户，卑劣、好色、贪婪，矮小、长相卑劣

利倉	利仓	人名，男性，中年，高峰神社的神主，原先是其兄死后继承，参与陷害悠志郎家，伪善、好色、贪婪、对侄女诗帆里有扭曲欲望
叔父様	叔父大人	人名，男性，诗帆里对利仓的称呼

編集長	总编辑	人名代称，男性，中年，四季风出版社的总编辑

メイド頭	女仆长	人名代称，女性，近40岁，久岛家女仆长、久岛的性调教对象

ジョナス	乔纳斯	人名，男性
ロバアト	罗巴特	人名，男性
タマキ	珠姫	人名，女性
座長	团长	人名代称，男性，中年以上，剧团团长

# 其他 ----------------------------------------------------------------------

ミルクホウル	奶咖厅	咖啡店的名称
リープフェン	莉芙卿	德语 Liebchen 音译，男性对女性的轻浮称呼，带有调戏意味
メッチェン	玫沁	德语 Mädchen 音译，"小姑娘"的意思
高峯神社	高峰神社	地名/神社名
ガラス人形	玻璃人偶	悠志郎留学时买给奈奈子的礼物，家族破产被瓜分，成为复仇的象征物
ベネチアンガラス	威尼斯玻璃人偶	悠志郎留学时买给奈奈子的礼物，家族破产被瓜分，成为复仇的象征物
リサイタル	独奏会	天才少女钢琴家千纮的首次个人独奏音乐会
四季風	四季风	出版社的名字